40 8 9
32112211
11112111
21323122
31331231
32213132
23113231
32111132
11222222
12132311
31223113
22231333
22311121
11312113
33221313
32321121
11232132
22123113
21133121
32222211
23231313
13131133
33232322
21121333
21123212
13232223
33321312
13122311
21322212
21333113
33123333
32133213
23321232
33131321
13223122
13212113
31113331
33123221
13132221
31313222
20331111