7 18 5
111111113333322212
312122231212312211
113111211123112223
111131212212313222
311332322133232133
321122231333311123
321110232333111132
