38 12 8
223133311232
113112312311
313211311213
223112332313
221131121132
313121211123
232323222123
113321133211
311112212132
132332323332
122223331311
212132312233
132322233223
231233331212
332312323113
321213223333
211113121112
311133232112
323231333111
231112311123
123131311133
112131322113
222113131231
112212112322
212223113231
222331112322
321333312133
133211332332
333332323131
221333333223
333112322333
113131211123
333232122232
222332331113
231313113312
212223222311
131331111121
331212311310
