43 39 5
313213123321322113112323111323233232232
131232313232123222231312211223233112232
232211313312322223113311211112131333112
213211221311113132133213133133333133221
333121231322313131312132311131222221112
313223233113121212313111331332321322333
132132331321332131121232313133321312331
332323323132233231311333121132123312313
222232123211233231332113133222121213333
133122123333332123322111121113232231323
121312223232222112323232312131131133132
221312321131223132212113311111131123213
111123321232322112312131111323312323331
211113332131332312123313132131121111122
111211313121322111123221132111223221111
331311111122132312121211213122133223331
333112312131111221121333322331333213212
112321213222332332133123331321132131211
231313132323312223312213313221131133232
112131122312312211321132313123322231222
131222211311331213223311212112112121113
313213112232131313123322311123111313312
133222132222131311221231113223222133221
113121132122332311111132321123231321312
313223133123133311333121122333232121113
222321321122133232212112332132211313222
133322221233123112131312123332132312231
311121313132333211323222112221221323212
133131133121221211113312232132232111111
331122331212121132233312321233132233132
312122322231221113111221113232123233212
221121322112312231312313332223131311312
231232223211213231113311112221223233322
321112233323111212321313122221231321313
133233233231123221231111313133322212133
231231232112131232222231222221121231331
211221323121323231322222131312131111323
322122213223112131122333323123233112132
312123221213211321323121233223213223121
223311321132232212131312223212213213132
223222212131212122122122221132232122333
332223233121133121233112311331111233211
111222211121133333333130112113112213321
